01111111
11111011
11111111
11011111
11111111
11101111
11111111