00010001
00010001
00010001
00010001
00000000
00000000
00000000
11111111